19
-20
8
-11
0000000000000000000000000000000000000000
0000000000000000000000000000000000000000
0000000000000000000000000000000000000000
0000000000000000000000000000000000000000
0000011111111111111111111111111111100000
0000011111111111111111111111111111100000
0000000000000001110000000000000000000000
0000000001000000000000000000000000000000
0000000000000000000000011100000000000000
0000000000000000000000011100000000000000
0000000000000000000000000000000000000000
0000000001000000000000000000001110000000
0000000001000000000000000000001110000000
0000000000000000000000000000000000000000
0000000000000000000000000000000000000000
0000000000000000000000000000000000000000
0000000000000000000000000000000000000000
0000000000000000000000000000000000000000
0000000000000000000000000000000000000000
0000000000000000000000000000000000000000
