15
-15
5
-4
0000000000000000000000000000000
1111111111111111111111111111110
1111111111111111111111111111110
0000000000111000000000000000000
0000100000000000000000000000000
0000000000000000001110000000000
0000000000000000001110000000000
0000000000000000000000000000000
0000100000000000000000000111000
0000100000000000000000000111000
